5 5 5 5 5 5 5 14 11 10 0 0 0 0 0 0 0 0 0 0 0 0 0 0 0 0 0 0 0 0 0 0 0 0 0 0 0 0 0 0 0 0 12 11 15 5 5 5 5 5
5 5 5 5 5 5 14 10 0 0 0 0 1 0 0 0 0 0 0 0 0 0 0 1 0 0 0 0 0 0 0 0 0 0 0 0 0 0 0 0 0 0 0 0 13 5 5 5 5 5
5 5 5 5 5 5 9 0 0 0 0 0 0 0 0 0 0 0 0 0 0 0 0 0 0 0 0 0 0 0 0 0 0 0 0 0 0 1 0 0 0 0 0 0 13 5 5 5 5 5
5 5 5 5 5 5 9 0 0 0 2 0 0 0 0 0 0 0 0 0 0 0 0 0 0 0 0 0 0 0 0 0 0 0 0 0 0 0 0 0 0 0 0 0 13 5 5 5 5 5
5 5 5 5 5 14 10 0 0 0 0 0 0 0 0 0 0 0 0 0 0 0 0 0 0 0 0 0 0 0 0 0 0 0 0 0 0 0 0 0 0 0 0 0 13 5 5 5 5 5
5 5 5 5 5 9 0 0 0 0 0 0 0 0 0 0 1 0 0 0 0 0 0 2 0 0 0 0 0 0 0 1 0 0 0 0 0 0 20 0 0 0 0 0 13 5 5 5 5 5
5 5 5 5 5 9 0 0 0 0 0 0 0 0 0 0 0 0 0 0 0 0 0 0 0 0 0 0 0 0 0 0 0 0 0 0 0 0 19 0 0 0 0 0 12 15 5 5 5 5
5 5 5 5 14 10 0 1 0 0 0 0 0 0 0 0 0 0 0 0 0 0 0 0 0 0 0 0 0 0 0 0 0 0 0 0 0 21 18 2 0 0 0 0 0 13 5 5 5 5
5 5 5 5 9 0 0 0 0 0 0 0 0 0 0 0 0 0 0 0 0 0 0 0 0 0 0 0 0 0 0 0 0 0 0 0 0 24 23 0 0 0 0 0 0 13 5 5 5 5
5 5 5 5 9 0 0 0 0 0 0 0 0 0 0 0 0 0 0 0 0 0 0 0 1 0 0 0 0 0 0 0 0 0 0 0 0 20 19 0 0 0 0 0 0 13 5 5 5 5
5 5 5 14 10 0 0 0 0 0 0 0 0 0 0 0 0 0 0 0 0 0 0 0 0 0 0 0 0 0 0 0 0 0 0 0 0 23 18 0 0 0 0 0 0 13 5 5 5 5
5 5 5 9 0 0 0 0 1 0 0 0 0 0 0 0 0 0 0 2 0 0 0 0 0 0 0 2 1 0 0 0 0 0 0 2 0 0 24 22 0 0 0 0 0 12 15 5 5 5
5 5 5 9 0 0 0 0 0 0 0 0 0 0 0 0 0 0 0 0 0 0 0 0 0 0 0 4 3 0 0 1 0 0 0 0 0 0 0 20 22 0 0 0 0 0 13 5 5 5
5 5 5 9 0 0 0 0 0 0 0 0 0 1 0 0 0 0 0 0 0 0 0 0 0 0 0 0 0 0 0 0 0 0 0 0 0 0 2 23 19 0 1 0 0 0 13 5 5 5
5 5 5 9 0 0 0 0 0 0 0 0 0 0 0 0 0 0 0 0 0 20 21 0 0 3 0 0 0 0 0 0 0 0 0 0 0 0 0 21 20 0 0 0 0 0 13 5 5 5
5 5 5 9 0 0 0 0 0 0 0 0 0 0 0 0 0 2 0 0 0 18 19 0 0 0 0 0 0 0 1 0 0 0 0 0 0 0 0 19 18 0 0 0 0 0 13 5 5 5
5 5 5 9 0 0 0 0 0 0 0 0 2 0 0 0 0 0 0 0 0 24 18 19 22 0 0 0 0 0 0 0 0 0 0 0 0 0 0 24 20 0 0 0 0 0 13 5 5 5
5 5 5 9 0 0 0 0 0 0 0 0 0 0 0 0 0 0 0 0 0 0 1 18 24 0 0 0 0 0 0 0 0 0 0 0 0 0 1 18 22 0 0 0 0 0 12 15 5 5
5 5 5 9 0 0 0 0 0 0 0 0 0 0 0 0 0 0 0 0 0 0 0 0 20 18 19 0 0 0 0 0 0 0 0 0 0 0 0 19 23 0 0 0 0 0 0 13 5 5
5 5 5 17 8 0 0 0 0 0 0 0 0 0 1 0 0 0 0 0 0 0 0 0 0 20 21 22 0 0 1 0 0 0 0 0 0 0 22 24 0 0 0 0 0 0 0 13 5 5
5 5 5 5 9 0 0 0 1 0 0 0 0 0 0 0 0 0 0 0 0 0 0 0 0 0 24 18 22 0 0 0 0 0 0 0 0 21 23 20 0 0 0 0 0 0 0 13 5 5
5 5 5 5 9 0 0 0 0 0 0 0 0 0 0 0 0 0 0 0 0 0 0 0 0 0 0 0 24 19 21 22 0 0 0 0 0 19 24 0 0 0 0 0 0 0 0 13 5 5
5 5 5 5 9 0 0 0 0 0 0 0 0 0 0 0 0 0 0 0 0 0 0 0 0 0 0 0 0 20 21 22 18 0 0 21 23 18 23 0 0 1 0 0 0 0 0 13 5 5
5 5 5 5 17 8 0 0 0 0 0 0 0 0 0 0 0 0 0 0 1 0 0 0 0 0 0 0 0 0 0 20 18 21 23 19 23 0 0 0 0 0 0 0 0 0 0 13 5 5
5 5 5 5 5 9 0 0 0 0 0 0 1 0 0 0 0 0 0 0 0 0 0 0 0 0 0 0 0 0 0 0 23 20 0 0 1 0 0 0 0 0 0 0 0 0 0 12 15 5
5 5 5 5 5 9 0 0 0 0 0 0 0 0 0 0 0 0 0 0 0 0 0 0 0 0 0 0 6 7 7 7 7 8 0 0 0 0 0 0 0 0 0 0 0 0 0 0 13 5
5 5 5 5 5 17 8 0 0 0 0 0 0 0 0 0 2 0 0 0 0 0 0 6 7 7 7 7 16 5 5 5 5 17 7 7 7 8 0 0 0 0 0 2 0 0 0 0 13 5
5 5 5 5 5 5 9 0 0 0 0 0 0 0 0 0 0 0 0 6 7 7 7 16 5 5 5 5 5 5 5 5 5 5 5 5 5 17 7 7 8 0 0 0 0 0 0 0 13 5
5 5 5 5 5 5 17 7 7 7 7 7 7 7 7 7 7 7 7 16 5 5 5 5 5 5 5 5 5 5 5 5 5 5 5 5 5 5 5 5 17 7 7 7 7 8 0 0 13 5
5 5 5 5 5 5 5 5 5 5 5 5 5 5 5 5 5 5 5 5 5 5 5 5 5 5 5 5 5 5 5 5 5 5 5 5 5 5 5 5 5 5 5 5 5 17 7 7 16 5
5 5 5 5 5 5 5 5 5 5 5 5 5 5 5 5 5 5 5 5 5 5 5 5 5 5 5 5 5 5 5 5 5 5 5 5 5 5 5 5 5 5 5 5 5 5 5 5 5 5
5 5 5 5 5 5 5 5 5 5 5 5 5 5 5 5 5 5 5 5 5 5 5 5 5 5 5 5 5 5 5 5 5 5 5 5 5 5 5 5 5 5 5 5 5 5 5 5 5 5 5