5 5 5 5 5 5 5 14 11 10 0 0 0 0 0 0 0 0 0 0 0 0 0 0 0 0 0 0 0 0 0 0 0 0 0 0 0 0 0 0 0 0 12 11 15 5 5 5 5 5
5 5 5 5 5 5 14 10 0 0 0 0 1 0 0 0 0 1 0 0 0 0 0 1 0 0 0 2 0 0 0 0 0 0 0 0 0 0 0 0 0 0 0 0 13 5 5 5 5 5
5 5 5 5 5 5 9 0 0 0 0 0 0 0 0 0 0 0 0 0 0 0 0 0 0 0 0 0 0 0 0 0 0 0 0 0 0 1 0 0 0 0 0 0 13 5 5 5 5 5
5 5 5 5 5 5 9 0 0 0 2 0 0 0 0 0 0 0 0 0 0 0 0 0 0 0 0 0 0 0 0 0 0 0 0 0 0 0 0 0 0 0 0 0 13 5 5 5 5 5
5 5 5 5 5 14 10 0 0 0 0 0 0 0 0 0 0 0 0 0 0 0 0 0 0 0 0 0 0 0 0 0 0 0 0 0 0 0 0 0 0 0 0 0 13 5 5 5 5 5
5 5 5 5 5 9 0 0 0 0 0 0 0 0 0 0 1 0 0 0 0 0 0 2 0 0 0 0 0 0 0 1 0 0 0 0 0 0 0 1 0 0 0 0 13 5 5 5 5 5
5 5 5 5 5 9 0 0 0 0 0 0 0 0 0 0 0 0 0 0 0 0 0 0 0 0 0 0 0 0 0 0 0 0 0 0 0 0 19 21 0 0 0 0 12 15 5 5 5 5
5 5 5 5 14 10 0 1 0 0 0 0 0 0 0 0 0 0 0 0 0 0 0 0 0 0 0 0 0 0 0 0 0 0 2 0 0 19 29 22 0 0 0 0 0 13 5 5 5 5
5 5 5 5 9 0 0 0 0 0 0 0 0 0 0 0 0 0 0 0 0 0 0 0 0 0 0 0 0 0 0 0 0 0 0 0 0 26 18 22 0 0 0 0 0 13 5 5 5 5
5 5 5 5 9 0 0 0 0 0 0 0 0 1 0 0 0 0 0 0 0 0 0 0 1 0 0 0 0 0 0 0 0 0 0 0 0 26 27 23 0 0 0 0 0 13 5 5 5 5
5 5 5 14 10 0 0 0 0 0 0 0 0 0 0 0 0 0 0 0 0 0 0 0 0 0 0 0 0 0 0 0 0 0 0 0 0 26 22 0 3 0 0 0 0 13 5 5 5 5
5 5 5 9 0 0 0 0 1 0 0 0 0 0 0 0 0 0 0 2 0 0 0 0 0 0 0 2 0 0 0 0 0 0 0 2 0 26 30 20 21 0 0 0 0 12 15 5 5 5
5 5 5 9 0 0 0 0 0 0 0 0 0 0 0 0 0 0 0 0 0 0 0 0 0 0 0 4 0 0 0 0 0 0 0 0 0 25 24 28 22 0 0 0 0 0 13 5 5 5
5 5 5 9 0 0 0 0 0 0 0 0 0 1 0 0 0 0 0 0 0 0 0 0 0 0 0 0 0 0 0 0 0 0 0 0 0 0 2 26 22 0 1 0 0 0 13 5 5 5
5 5 5 9 0 1 0 0 0 0 0 0 0 0 0 0 0 0 0 0 19 20 21 0 0 3 0 0 0 0 0 0 0 0 0 0 0 0 19 29 22 0 0 0 0 0 13 5 5 5
5 5 5 9 0 0 0 0 0 0 0 0 0 0 0 0 0 2 0 0 25 28 30 21 0 0 0 0 0 0 1 0 0 0 0 0 0 0 26 18 22 4 0 0 0 0 13 5 5 5
5 5 5 9 0 0 0 0 0 0 0 0 2 0 0 0 0 0 0 0 0 25 28 30 21 0 0 0 0 0 0 0 0 0 0 0 0 0 26 18 22 0 0 0 0 0 13 5 5 5
5 5 5 9 0 0 0 0 0 0 0 0 0 0 0 0 0 0 0 0 0 0 25 28 30 21 0 0 0 0 0 0 0 0 2 0 0 0 26 18 22 0 0 0 0 0 12 15 5 5
5 5 5 9 0 0 0 0 0 0 0 0 0 0 0 0 0 0 1 0 0 0 0 26 18 22 0 0 0 0 0 0 0 0 0 4 0 0 26 18 22 0 0 0 0 0 0 13 5 5
5 5 5 17 8 0 0 0 0 0 0 0 0 0 1 0 0 0 0 0 0 0 0 25 28 30 20 21 2 0 0 0 0 0 0 0 0 19 29 18 22 0 0 0 0 0 0 13 5 5
5 5 5 5 9 0 0 0 1 0 0 0 0 0 0 0 0 0 0 0 0 0 0 0 25 28 18 30 21 0 0 0 0 0 0 0 19 29 18 27 23 0 0 0 0 2 0 13 5 5
5 5 5 5 9 0 0 0 0 0 0 0 0 0 0 0 0 0 0 0 0 0 0 0 0 25 24 28 30 20 20 21 0 0 0 19 29 18 27 23 0 0 0 0 0 0 0 13 5 5
5 5 5 5 9 0 0 0 0 0 0 0 0 0 0 0 0 0 0 0 0 0 0 0 0 0 0 25 24 28 18 30 20 20 20 29 27 24 23 0 0 0 0 0 0 0 0 13 5 5
5 5 5 5 17 8 0 0 0 0 0 0 0 0 0 0 0 2 0 0 1 0 0 0 0 0 0 0 0 25 24 28 18 18 18 27 23 0 0 0 0 3 0 0 0 0 0 13 5 5
5 5 5 5 5 9 0 0 0 0 0 0 1 0 0 0 0 0 0 0 0 0 0 0 0 0 0 0 0 0 0 25 24 24 24 23 1 0 0 0 0 0 0 0 0 0 0 12 15 5
5 5 5 5 5 9 0 1 0 0 0 0 0 0 0 0 0 0 0 0 0 0 0 0 0 0 0 0 6 7 7 7 7 8 0 0 0 0 0 0 0 0 0 0 0 0 0 0 13 5
5 5 5 5 5 17 8 0 0 0 0 0 0 0 0 0 2 0 0 0 0 0 0 6 7 7 7 7 16 5 5 5 5 17 7 7 7 8 0 0 0 0 0 0 0 0 0 0 13 5
5 5 5 5 5 5 9 0 0 0 0 0 0 0 0 0 0 0 0 6 7 7 7 16 5 5 5 5 5 5 5 5 5 5 5 5 5 17 7 7 8 0 0 0 0 0 2 0 13 5
5 5 5 5 5 5 17 7 7 7 7 7 7 7 7 7 7 7 7 16 5 5 5 5 5 5 5 5 5 5 5 5 5 5 5 5 5 5 5 5 17 7 7 7 7 8 0 0 13 5
5 5 5 5 5 5 5 5 5 5 5 5 5 5 5 5 5 5 5 5 5 5 5 5 5 5 5 5 5 5 5 5 5 5 5 5 5 5 5 5 5 5 5 5 5 17 7 7 16 5
5 5 5 5 5 5 5 5 5 5 5 5 5 5 5 5 5 5 5 5 5 5 5 5 5 5 5 5 5 5 5 5 5 5 5 5 5 5 5 5 5 5 5 5 5 5 5 5 5 5
5 5 5 5 5 5 5 5 5 5 5 5 5 5 5 5 5 5 5 5 5 5 5 5 5 5 5 5 5 5 5 5 5 5 5 5 5 5 5 5 5 5 5 5 5 5 5 5 5 5 5